NO ./textures/red.xpm
SO ./textures/bluestone.xpm
WE ./textures/greystone.xpm
EA ./textures/eagle.xpm

F 255,12,1
C 240,200,255

11111111111
10000000001
1000E000001
10000000001
11111111111
